WWWWWWWWWWWWWWWWWWWW
WU...W........W....W
W.WW.W.WWWWWW.W.WW.W
W.W..............W.W
W.W.WW.WW  WW.WW.W.W
W.P....WROIBW......W
W.W.WW.WWWWWW.WW.W.W
W.W..............W.W
W.WW.W.WWWWWW.W.WW.W
W....W........W...UW
WWWWWWWWWWWWWWWWWWWW