WWWWWWWWWWWWWWWWWWWWWWWWWWWWWWWWWWWWWWWW
W..P.....................U.............W
WWWWWWWWW.WWWWWWWWW.W.WWWWWWWWWWWWWWWWWW
W        .W       W W  W               W
W.WWWWWWW.WWWWWWWWW.W.WWWWWWWWWWWWWWWWWW
W..S..............................R....W
WWWWWWWWWWWWWWWWWWWWWWWWWWWWWWWWWWWWWWWW