WWWWWWWWWWWWWWWWWWWWWWWWWWWWWWWWWWWWWWWW
W..P.....................U.............W
WWWWWWWWWWWWWWWWWWW....WWWWWWWWWWWWWWWWW
W                 W    W               W
WWWWWWWWWWWWWWWWWWW    WWWWWWWWWWWWWWWWW
W..S..............................G....W
WWWWWWWWWWWWWWWWWWWWWWWWWWWWWWWWWWWWWWWW