WWWWWWWWWWWWWWWWWWWWWWWWWWWWWWWWWWWWWWWW
WU.P.....................U.............W
WWWWWWWWW.WWWWWWWWW.W.WWWW.WWWWWW.WWWWWW
W.........WWWWWWWWW.W.W................W
W.WWWWWWW.WWWWWWWWW.W.WWWWWWWWWWW.WWWWWW
W..S...I...O....B.................R...UW
WWWWWWWWWWWWWWWWWWWWWWWWWWWWWWWWWWWWWWWW