WWWWWWWWWWWWWWWWWWWWWWWWWWWWWWWWWWWWWWWW
W.P....W.W.W.W.W.W.W.W.W.W.W.W.W.W.W.W.W
W.WWWW.W.W.W.W.W.W.W.W.W.W.W.W.W.W.W.W.W
W.W....W.W.W.W.R.O.I.B.W.W.W.W.W.W.W.W.W
W.W.WW.W.W.W.W.S.......W.W.W.W.W.W.W.W.W
W.W.W..W.W.W.W.WWWWWWW.W.W.W.W.W.W.W.W.W
W.W.W.WW.W.W.W.W.W.W.W.W.W.W.W.W.W.W.W.W
W.U....W.W.W.W.W.W.W.W.W.W.W.W.W.W.W.W.W
W.WWWWWWWWWWWWWWWWWWWWWWWWWWWWWWWWWWWW.W
W....................................U.W
WWWWWWWWWWWWWWWWWWWWWWWWWWWWWWWWWWWWWWWW