WWWWWWWWWWWWWWWWWWWWWWWWWWWWWWWWWWWWWWWW
W.U..................................U.W
W.W.WWWW.W.WWWW.W.WWWW.W.WWWW.W.WWWW.W.W
W.W.W....W.W....W.W....W.W....W.W....W.W
W.W.WWWW.W.WWWW.W.WWWW.W.WWWW.W.WWWW.W.W
W.P......R.O.I.B...................S...W
W.WW.W.WW.W.WWWWWWWWWWWWWWWW.W.WW.W.WW.W
W....W.W.......S.......W.W....W.W....W.W
W.WW.W.W.WWWWWW.W.W.W.WWWWWW.W.W.WW.W.WW
W......................................W
WWWWWWWWWWWWWWWWWWWWWWWWWWWWWWWWWWWWWWWW