WWWWWWWWWWWWWWWWWWWWWWWWWWWWWWWWWWWWWWWW
W.U..................................U.W
W.WWWWWWWW.W.WWWWWWWWWWWWWW.W.WWWWWWWW.W
W.W....W.W.W.W.W.........W.W.W.W....W.WW
W.W.WW.W.W.W.W.W.WWWWWWWW.W.W.W.WW.W.WWW
W.W.W..W.W.W.W.R.O.I.B....W.W.W.W..W.WWW
W.W.W.WW.W.W.W.S..........W.W.W.WW.W.WWW
W.W.WWWW.W.W.W.WWWWWWWWWW.W.W.WWWW.W.WWW
W.W....W.W.W.W.W.........W.W.W.W....W.WW
W.WWWWWWWW.W.WWWWWWWWWWWWWW.W.WWWWWWWW.W
W.P................................S...W
WWWWWWWWWWWWWWWWWWWWWWWWWWWWWWWWWWWWWWWW